abstact=abstract
Abstact=Abstract
acceses=accesses
accessability=accessibility
Accoring=According
Accquire=Acquire
actuallized=actualized
adherance=adherence
Aggregatses=Aggregates
Aggreggates=Aggregates
achives=achieves
Alcololic=Alcoholic
allong=along
allways=always
alredy=already
analyed=analyzed
analyer=analyzer
Analzyer=Analyzer
anothe=another
appraently=apparently
Aquire=Acquire
aquired=acquired
arbitarily=arbitrarily
arbiterary=arbitrary
Arguement=Argument
Assignement=Assignment
assumptios=assumptions
attibute=attribute
attibutes=attributes
Avaliable=Available
avarage=average
becamee=became
begining=beginning
behavoir=behavior
betweeen=between
betwen=between
beween=between
Cachability=Cacheability
Cacheing=caching
calculateed=calculated
callibrate=calibrate
Capitlizing=Capitalizing
captial=capital
catetory=category
clazz=class
collapsable=collapsible
Collapsable=Collapsible
comparision=comparison
compatability=compatibility
compatibity=compatibility
completedness=completeness
completly=completely
concetenation=concatenation
conjuction=conjunction
consoant=consonant
controll=control
contsructor=constructor
conusion=confusion
Convertable=Convertible
corrcetly=correctly
correcty=correctly
correponding=corresponding
corrsponding=corresponding
corrumpted=corrupted
couldnt=couldn't
couterpart=counterpart
customizeable=customizable
decresing=decreasing
delimter=delimiter
deterimine=determine
dicationary=dictionary
differnce=difference
differnetly=differently
diposing=disposing
dipsosable=disposable
disctinct=distinct
disjunctn=disjunct
displaing=displaying
Distinc=Distinct
doens't=doesn't
does't=doesn't
DoTestStopPositons=Positions
duplcate=duplicate
eficient=efficient
elemnts=elements
elminate=eliminate
elmination=elimination
embeded=embedded
emptyness=emptiness
emtpy=empty
Enumberable=Enumerable
Enusure=Ensure
exaclty=exactly
excepetion=exception
Exclution=Exclusion
excpetion=exception
Excpetion=Exception
excpetions=exceptions
excusion=exclusion
exeception=exception
execeptions=exceptions
Exeption=Exception
exeptions=exceptions
Exhasting=Exhausting
expanMultiTerm=expand
explicitely=explicitly
explicity=explicitly
faild=failed
fininishing=finishing
fluhsed=flushed
followng=following
followon=following
formated=formatted
Fuction=Function
fuctionality=functionality
generalizatio=generalization
genereic=generic
highligh=highlight
choosen=chosen
Icrements=Increments
idenfifier=identifier
Idenitifies=Identifies
Idenity=Identity
identifer=identifier
immeidate=immediate
immidiately=immediately
implemenation=implementation
implemetation=implementation
implicitely=implicitly
implmentation=implementation
independant=indenpendent
indivual=individual
infact=in fact
ingored=ignored
initailized=initialized
initalization=initialization
Initalizer=Initializer
initialCapcity=Capacity
initilization=initialization
insenitive=insensitive
instace=instance
instaed=instead
intance=instance
intialization=initialization
intialized=initialized
intstance=instance
investiagtion=investigation
IsInvokableSubclassOf=Invocable
isnt=isn't
itsself=itself
lamdba=lambda
leftovr=leftover
lenght=length
maling=mailing
mappping=mapping
mapps=maps
Matchingm=Matching
matchs=matches
Matchs=Matches
maxium=maximum
maxTestTermLegnth=Length
metods=methods
mimick=mimic
mimicks=mimics
minmize=minimize
Muliple=Multiple
neccessary=necessary
nonexistant=nonexistent
nonnull=non-null
Numric=Numeric
occaasional=occasional
occationally=ocassionaly
occurances=occurrences
occuriong=occuring
offets=offsets
ommitted=omitted
Operaions=Operations
oposite=opposite
overrided=overridden
Overrided=Overridden
Overriden=Overridden
ovewrite=overwrite
palyndrome=palindrome
Palyndrome=Palindrome
parameterized=parametrized
paranthesis=parenthesis
Parellel=ParallelReader
parenthesised=parenthesized
pases=passes
perfromance=performance
portoguese=portuguese
posessive=possessive
posfix=postfix
Positons=Positions
postions=positions
previoulsy=previously
probabliltiy=probability
propery=property
propeties=properties
propety=property
quantize=quantitize
quantized=quantitized
quries=queries
randomoly=randomly
readonlyly=readonly
redundent=redundant
reeentrant=reentrant
Refreh=Refresh
refrenced=referenced
relativly=relatively
repetiotion=repetition
respnsibility=responsibility
retreived=retrieved
returend=returned
Reverese=Reverse
reveresed=reversed
sefault=default
sensititive=sensitive
seperate=separate
seperated=separated
seperator=separator
serializeability=serializability
shouldnt=shouldn't
siltenlty=silently
simplifed=simplified
Souce=Source
speacial=special
specifc=specific
specifiy=specify
spezification=specification
Sream=Stream
stabelize=stabilize
Stardard=Standard
sublcass=subclass
succed=succeed
succesfully=successfully
sucessfully=successfully
suggstion=suggestion
suppresed=suppressed
supress=suppress
synatax=syntax
synchornized=synchronized
Synomyms=Synonyms
Targt=Target
taxononmy=taxonomy
Temorary=Temporary
TestHighlightUnknowQueryAfterRewrite=Unknown
TestHighlightUnknowQueryAnonymousHelper=Unknown
TestNonexistantFields=Nonexistent
thats=that's
ther=then
thie=this
threashold=threshold
threefore=therefore
timedout=timeout
udpate=update
Uffer=uffer
ugprade=upgrade
Unfotunately=Unfortunately
Unqoted=Unquoted
unusd=unused
usecase=use case
usefull=useful
utilty=utility
valies=values
vebose=verbose
verision=version
weired=weird
wellformed=well-formed
whith=with
wouldnt=wouldn't
Wraping=Wrapping